NO ./_textures/north/halloween.png
SO ./_textures/south/halloween1.png
WE ./_textures/west/halloween2.png
EA ./_textures/east/halloween3.png
F 0,0,0
C 0,0,0

        1111111111111111111111111
        1000000000110000000000001
        1011000001110000000000001
10000000001100000111011111D111111
11110111111111011100000010001
11110111111111011101010010001
11000000110101011100000010001
10000000000000001100000010101
10000000000000001101010010001
11000001110101011111011110N0111
11110111 1110101 101111110001
11111111 1111111 111111111111